en tant que tel	en tant que tel (loc adv) in its current form, as it is, as such Examples: Pour être accepté en tant que tel
nourrir	nourrir (vtr) to feed Examples: Nourrir le système patriarcal
renoncer à	renoncer à (vtr/vi) to renounce sth, to give up on something, not do sth anymore Examples: C'est trop difficile, je renonce Renoncer à quelque chose
agacer	agacer (vtr) to annoy, to irritate, to get on your nerves Examples: C'est un truc qui nous agace profondément
persévérer	persévérer (vi) to perservere Examples: Il faut persévérer
querelle	querelle (nf) quarrel, dispute
pourparlers	pourparlers (nmpl) talks, negotiations Examples: La Russie propose d'accueiller des pourparlers
subir	subir (vtr) to suffer, to be subjected to
étaler	étaler (vtr) to spread out, to spread Examples: Les feuilles tu vas les étaler
filtrer	filtrer (vi/vtr) to filter Examples: Le lendemain on filtre Je filtre le jus d'orange
déchirer	déchirer (vtr) to tear, to rip / to tear [sth] up, to rip [sth] up Examples: J'ai déchiré mon jean
carrément	carrément (adv) totally, really / straight out / (interj) You bet! / (interj) No way!
faire le plein de [qch]	faire le plein de [qch] (loc + prep) stock up on sth Examples: J'ai fait le plein de chocolat
repoussant	repoussant (adj) repulsive, repellent
taupe	taupe (nf) mole
arnaque	arnaque (nf) fraud, robbery, scam Examples: Il y a beaucoup d'arnaques sur internet
tant mieux!	tant mieux! (interj) fine!, good!, so much the better
débile	débile (adj) idiotic, ridiculous, moronic
proie	proie (nf) prey, victim, target Examples: Le renard saisit sa proie
choper	choper (vtr) to catch to steal, to pick up (sortir avec qqn) Examples: Max essaie de choper une fille Je te lance la balle et tu essaies de la choper
avoir du cran	avoir du cran (expr) to have guts, to be brave Examples: Vous avez du cran, jeune femme
berceuse	berceuse (nf) lullaby / rocking chair Examples: La maman chantait une berceuse
rembaucher	rembaucher (vtr) rehire, re-employ / get back to work, start work again Examples: Elle a été rembauché cet été
avoir le moral dans les chaussettes	avoir le moral dans les chaussettes (expr) to be down in the dumps, to be low in spirits Examples: Vous semblez avoir le moral dans les chaussettes
ficelle	ficelle (nf) string / when in plural form: tricks, secrets, ins and outs Examples: Apprenez-lui toutes les ficelles du métier Entoure le paquet d'une ficelle
livrer [qch] (à [qqn])	livrer [qch] (à [qqn]) (vtr) to deliver [sth] to [sb]/ to deliver Examples: Ce magasin nous a livré notre machine à laver en 4 jours Tu veux essayer de livrer le courrier?
filer	filer (vi) (quitter rapidement un lieu) to run, dash off, fly, be off Examples: Excuse-moi, il est midi, il faut que je file Filez, soyez libre
Je m'en doutais	Je m'en doutais (expr) I was suspecting as much, I was imagining so
repérer	repérer (vtr) to notice, spot, detect
bouleverser	bouleverser (vtr) figurative: upset, disrupt, / devestate, overwhelm, move [sb] deeply Examples: La mort des enfants dans cet accident a bouleversé le village
glauque	glauque (adj) shady, seedy / blue-green, (water) murky Examples: C'est glauque, non?
louche	louche (adj) shady, shifty, suspect Examples: Cette histoire est bien loche
radin/radine	radin/radine (adj/nm/nf) stingy / cheapskate
fauché	fauché (adj) penniless, broke Examples: Tu sais bien que je suis fauchée
acharnement	acharnement (nm) relentlessness, tenacity, dedication / persecution, harassment
fossé	fossé (nm) ditch, moat / (figurative) gap, gulf Examples: le fossé entre animhommes et humains persistent
Ne t'emballe pas!	Ne t'emballe pas! (expr) don't get ahead of yourself, don't get carried away
fardeau	fardeau (nm) burden, load, weight
chiffoner [qch/qqn]	chiffoner [qch/qqn] (vtr) to crumple [sth] up/to bother, worry Examples: Il y a quelque chose qui me chiffonne
chatouiller	chatouiller (vtr) tickle Examples: ça chatouille! la jeune maman chatouillait son bébé
achever	achever (vtr) finish, complete Examples: Vous pourrez lire mon roman quand je l'aurai achevé
se dérober à [qch]	se dérober à [qch] to evade, to shy away from [sth] Examples: Elle s'est dérobée à ses obligations
patrouille	patrouille (nf) patrol Examples: le lieutenant a envoyé une patrouille en reconaissance Les patrouilles sont plus nombreuses depuis l'attentat
se désintégrer	se désintégrer (vftr) to break up, disintegrate, decay Examples: Les roches se désintègrent naturellement par érosion
empêcher	empêcher (vtr) to prevent, avoid, put a stop to [sth] Examples: La conférence a empêché le conflit
démence	démence (nf) insanity, craziness Examples: Elle a sombré dans la démence après la mort de son mari
franchir	franchir (vtr) to jump over, break through, cross, pass Examples: Puis franchir le secteur du labyrinthe
en tant que [qqn/qch]	en tant que [qqn/qch] (loc adv + prep) as, in the capacity of Examples: En tant que maire, je souhaite développer le centre-ville En tant que guilde, nous ne pouvons pas accepter sans rien dire
balayer	balayer (vtr) to sweep
mollasson/mollassonne	mollasson/mollassonne (adj/nm/nf) sluggish, lethargic, lackluster / sluggish person, sluggard Examples: Mes hommes ne sont pas des mollassons!
goinfre	goinfre (nm) glutton, pig Examples: Tu es un vrai goinfre
faire le guet	faire le guet (expr) stake out, be on watch, be on the lookout Examples: pourquoi est-ce que tu fais le guet devant chez moi?
la moitié de [qch]	la moitié de [qch] (loc prep) half
donjon	donjon (nm) dungeon
quand il s'agit de...	quand il s'agit de... (expr) when it comes to Examples: quand il s'agit d'une fille comme toi
effrayer	effrayer (vtr) frighten
repérage	repérage (nm) tracking, spotting, finding
viser	viser (vi) aim / viser [qch] = aim at sth Examples: Il vaut mieux viser haut!
tiens!	tiens! (interj) here!, here you go (informal interjection)
récolter	récolter (vtr) to harvest, collect, reap
palier	palier (nm) landing, floor, stage
onde	onde (nf) wave (figurative and literal) Examples: Une onde de satisfaction L'onde de choc
péter un câble	péter un câble (expr) blow a fuse, lose it, go beserk Examples: Il a dû péter un câble!
je n'y manquerai pas	je n'y manquerai pas (expr) I won't forget it, I won't forget
parvenir	parvenir (vtr) reach, get as far as [sth]
convenir à [qch/qqn]	convenir à [qch/qqn] (vtr) be suitable for [sth/sb] Examples: Cette situation ne convient pas à Vladimir Poutine
camion	camion (nm) truck
déranger	déranger (vtr) disturb, bother, interrupt
sympa	sympa (adj) nice, likeable, kind, friendly
renseigner [qqn]	renseigner [qqn] (vtr) inform, give [sb] information, give information to [sb]
colistier/colistière	colistier/colistière (nm/nf) running mate, fellow candidate
pourri	pourri (adj) rotten, decayed, lousy
à moins que + [subjonctif]	à moins que + [subjonctif] (conj) unless
têtu	têtu (adj) stubborn, obstinate
déluge	déluge (nm) downpour, deluge, torrential rain
reconnaître	reconnaître (vtr) recognize, acknowledge
consacré à [qch/qqn]	consacré à [qch/qqn] (adj + prep) devoted to [sth/sb] / dedicated to [sth/sb]
empilement	empilement (nm) piling, stacking, piling up/stacking up
raccourci	raccourci (nm) shortcut, quick way
soupirer	soupirer (vi) to sigh
déprimé	déprimé (adj) depressed
nier	nier (vtr/vi) to deny
maudire	maudire (vtr) to curse (souhaiter malheur)
taré	taré (adj) out of your mind, crazy
secouer	secouer (vtr) shake, mix, figuratively shock, affect, shake up
secourir	secourir (vtr) save, help, rescue, give first aid to
parcourir	parcourir (vtr) travel, cross, roam, go all over [sth]
innombrable	innombrable (adj) countless, innumerable
aller de soi	aller de soi (phr) goes without saying
verser	verser (vtr) to pour
souffle	souffle (nm) breath/breeze
grève	grève (nf) strike
auprès de	auprès de (prep) near/close to/beside/next to
démissioner	démissioner (vi) resign/quit
redémarrer	redémarrer (vi) restart/start again
s'entêter	s'entêter (vf) to persist
affréter	affréter (vtr) to charter
embrouille	embrouille (nf) confusion, muddle
capituler	capituler (vi) to surrender, capitulate, give in
chagrin	chagrin (nm) grief
agacé	agacé (adj) Irritated, annoyed
Я в парке	(nm) park I am in the park
Je suis en live quasiment tous les jours sur ma chaîne Twitch	(adv) Almost I'm live almost everyday on my Twitch channel
